Hihat,Snare,Crash,HighTom,MidTom,LowTom,Ride,Base
1,0,0,0,0,0,0,1
1,0,0,0,0,0,0,0
1,1,0,0,0,0,0,0
1,0,0,0,0,0,0,0
1,0,0,0,0,0,0,0
1,0,0,0,0,0,0,1
1,1,0,0,0,0,0,0
1,0,0,0,0,0,0,0
